..o......oo......o..
..bb.....bb.....bb..
.....o........o.....
o....bb......bb....o
o.......o..o.......o
o....o..bbbb..o....o
o....bb......bb....o
o.o..............o.o
o.bb.....bb.....bb.o
o..................o
o....bb......bb....o
o........oo........o
........bbbb........
.....o........o.....
p....bb......bb.....
..bb............bb..
....ooooo..oooo.....
bbbbbbbbb..bbbbbbbbb